XXXXXXX
X     X
X XXX X
S XFX X
X X X X
X     X
XXXXXXX
