XXXXXXX
X     X
X XXX X
X  FX S
X XXX X
X     X
XXXXXXX