XXXXXXXXXXXXXXXXXXXX
X X   X  X         X
X XXX X XX XXXXXXX X
X     X XX X    XX X
X XXX X XX X XX    X
S XXX   XX XXXX XXXX
XXXXX X XX         X
X XXX X XXXXX XXXX X
X     X          X X
XXXXXXXXXX XXXXX X X
X              X X X
X XXXXXXXXXXXXXX X X
X X            X   X
X X XXXX XXXXX XXXXX
X   X XX X     X   X
XXXXX XX XXXXXXX X X
X   X    X   X   X X
X XXX XXXX X X XXX X
X          X   X   F
XXXXXXXXXXXXXXXXXXXX