XXXXXXXXXXXXXXXXXXXXXXXXXXXXXXXXXXXXXXXXXXXXXXXXXXXXXXXXXXXXXXXXXXXXXXXXXXXXXXXX
X X   X  X         XX X   X  X         XX X   X  X         XX X   X  X         X
X XXX X XX XXXXXXX XX XXX X XX XXXXXXX XX XXX X XX XXXXXXX XX XXX X XX XXXXXXX X
X     X XX X    XX XX     X XX X    XX XX     X XX X    XX XX     X XX X    XX X
X XXX X XX X XX    XX XXX X XX X XX    XX XXX X XX X XX    XX XXX X XX X XX    X
S XXX   XX XXXX XXXX  XXX   XX XXXX XXXX  XXX   XX XXXX XXXX  XXX   XX XXXX XXXX
XXXXX X XX         XXXXXX X XX           XXXX X XX         XXXXXX X XX         X
X XXX X XXXXX XXXX XX XXX X XXXXX XXXX XX XXX X XXXXX XXXX XX XXX X XXXXX XXXX X
X     X          X XX     X          X XX     X          X XX     X          X X
XXXXXXXXXX XXXXX X XXXXXXXXXXX XXXXX X XXXXXXXXXXX XXXXX X    XXXXXXXX XXXXX X X
X              X X XX              X X XX              X X XX              X X X
X XXXXXXXXXXXXXX X XX XXXXXXXXXXXXXX X XX XXXXXXXXXXXXXX X XX XXXXXXXXXXXXXX X X
X X            X   XX X            X   XX X            X   XX X            X   X
X X XXXX XXXXX XXXXXX X XXXX XXXXX XXXXXX X XXXX XXXXX XXXXXX X XXXX XXXXX XXXXX
X   X XX X     X   XX   X XX X     X   XX   X XX X     X   XX   X XX X     X   X
XXXXX XX XXXXXXX X XXXXXX XX XXXXXXX X XXXXXX XX XXXXXXX X XXXXXX XX XXXXXXX X X
X   X    X   X   X XX   X    X   X   X XX   X    X   X   X XX   X    X   X   X X
X XXX XXXX X X XXX XX XXX XXXX X X XXX XX XXX XXXX X X XXX XX XXX XXXX X X XXX X
X          X   X               X   X    X          X   X    X          X   X   F
XXXXXXXXXXXXXXXXXXXXXXXXXXXXXXXXXXXXXXXXXXXXXXXXXXXXXXXXXXXXXXXXXXXXXXXXXXXXXXXX