XXXXXXXXXX
X X   X  X
X XXX X XX
X     X XX
X XXX X XX
S XXX   XX
XXXXX X XX
X XXX X XX
X     X  F
XXXXXXXXXX